{
	"board": [
		[1, 1, 1, 1, 1, 1, 1, 1, 1, 4, 1],
		[1, 3, 0, 0, 0, 0, 0, 0, 1, 0, 1],
		[1, 0, 0, 0, 0, 0, 0, 0, 0, 0, 1],
		[1, 0, 0, 0, 0, 0, 0, 0, 0, 0, 1],
		[1, 0, 0, 0, 0, 0, 0, 0, 0, 0, 1],
		[1, 0, 0, 0, 0, 0, 0, 0, 1, 1, 1],
		[1, 0, 0, 0, 0, 0, 0, 0, 0, 0, 1],
		[1, 0, 0, 1, 0, 0, 0, 0, 1, 0, 1],
		[1, 0, 0, 1, 1, 1, 1, 0, 1, 0, 1],
		[1, 3, 0, 0, 0, 0, 1, 0, 1, 3, 1],
		[1, 1, 1, 1, 1, 1, 1, 1, 1, 1, 1]
	],
	"player": {
		"maxHealth": 100,
		"health": 100,
		"coords": [9, 1]
	},
	"enemies": [
		{
			"maxHealth": 100,
			"health": 100,
			"coords": [1, 1]
		},
		{
			"maxHealth": 100,
			"health": 60,
			"coords": [1, 9]
		},
		{
			"maxHealth": 100,
			"health": 75,
			"coords": [9, 9]
		}
	]
}
