{
	"board": [
		[1, 1, 1, 1, 1, 1, 1, 1, 1, 4, 1],
		[1, 0, 0, 0, 0, 0, 0, 0, 1, 0, 1],
		[1, 0, 0, 0, 0, 0, 0, 0, 0, 0, 1],
		[1, 0, 0, 0, 0, 0, 0, 0, 0, 0, 1],
		[1, 0, 0, 0, 0, 0, 0, 0, 0, 0, 1],
		[1, 0, 1, 0, 0, 0, 0, 0, 0, 0, 1],
		[1, 0, 1, 0, 0, 0, 0, 0, 0, 0, 1],
		[1, 0, 1, 0, 0, 0, 0, 0, 0, 0, 1],
		[1, 1, 1, 1, 1, 1, 1, 0, 0, 0, 1],
		[1, 0, 0, 0, 0, 0, 0, 0, 0, 0, 1],
		[1, 1, 1, 1, 1, 1, 1, 1, 1, 1, 1]
	],
	"player": {
		"maxHealth": 100,
		"health": 100,
		"coords": [9, 1]
	},
	"enemies": [
		{
			"maxHealth": 100,
			"health": 100,
			"coords": [5, 5]
		}
	]
}
